52 21 0 11 0 6
* * * * * * * * * * * * * * * * * * * * * * * * * * * * * * * * * * * * * * * * * * * * * * * * * * b b
* * * * * * * * * * * * * * * * * * * * * * * * * * * * * * * * * * * * * * * * * * * * * * * * * * b b
* * * * * * * * * * * * * * * * * * * * * * * * * * * * * * * * * * * * * * * * * * * * * * * * * * b b 
* * * * * * * * * * * * * * * * * * * t * * * * * * * * * * * * * * * * * * * * * * * * * * * * * * b b 
* * * * * * b * * * * * * * * * * * * b * * * * b e * b * * * * * * * * * * * * * * * * * * * * * * b b 
* * * * * * * * * * * * * * * * * * * b * b b * b b b b * * * b * * b * * * * * * t * * * * * * * * b b 
* * * * * * t * * * * * * * * * * b b b * * * * * * * * * * * * * * * * * * * * i i * * * * * * * * b b 
* * * * * * b * * * * * * * * * * * * * * * * * * * * * * * * * * * * * * * * i i i i * * * * * * * b b 
b * * e * b b b e * b * m * * n * e * e * b * b * e * b * * * * b * e b * * i i i i i i * * * * * * b b 
b b b b b b b b b b b b m * * n b b b b b b * b b b b b * * * * b b b b * i i i i i i i i i i i i i b b 
b b b b b b b b b b b b m * * n b b b b b b * b b b b b * * b b b b b b * b b b b b b b b b b b b b b b
p p p p p * * * * * * * * * * * * * * * * * * * * u * * * * * * * * * * * * * * * * * * * * * * * * b b
* * * * * * * * * * * * * v * * * * * * * * * * * * * * * b b * * * * * * * * * l l * * * * * * * * b b 
* * * * * * * * h * * * * * * * * f * * * * * * * * * * * * * * * * * * * * * * * * * * * * * * * * b b 
* * * * * * i * * * * * * * * * * * * i * * * * b e * b b b b * * * * * * * * * * * * * * * * * * * b b 
* * * * * * * * * * * * * * * l * * t i * b b * b b b b * * * b * * b * * * * * * * * * * * * * * * b b 
* * * * * * * * * * * * * * * * * i i i * * * * * * * * * * * * * * * * * * * * g g * * * * * * * * b b 
* * * * * * i * * * * * t * * * * * * * * * * * * * * * * * * * * * * * * * * g b b g * * * * * * * b b 
b r o o q i i i e * * o i * * g * e o e * m * n * e * b * * c * b * e b * * g b b b g g * * * * * d b b 
b b b b b b b i i i i i i * * b b b b b b m * n b b b b * * b * b b b b * g b b b b b g g g g g g g b b 
b b b b b b b b b b b b b * * b b b b b b m * n b b b b * * b * b b b b * b b b b b b b b b b b b b b b
